#########I#############
#.#.......#.........#.#
#.#.#####.###.#####.#.#
#.#.#...#.#...#...#...#
#.###.###.#.###.#####.#
#...#...#...#.....#...#
#.###.#.#########.#.###
#.....#.........#.#...#
#.###########.#.#.###.#
#.....#...#...#.#...#.#
#####.#.#.#.###.#.#.#.#
#.#...#.#.#.#.....#.#.#
#.#.###.#.#.#.#######.#
#...#.#.#.#.#...#.....#
#.###.#.#.#.###.#.#####
#...#...#.#.#...#.....#
###.#####.#.###.#####.#
#.#.#.....#...#.#.....#
#.#.#.###.###.#.#.#####
#...#...#...#.#.#.....#
#.#####.###.#.#######.#
#.....#.#...#.#.....#.#
#####.#.#.###.#.#.###.#
#...#.#.#...#...#.#...#
#.###.#.#########.#.###
#.....#.....#.....#...#
#.#########.#.#######.#
#...........#.........#
###########O###########
