###I###
#.....#
#.....#
#.###.#
#.....#
#.....#
###O###
